,國文,英文,數學,地理,歷史,總分,平均
1,75,85,76,82,98,416,83.2
2,65,79,77,70,82,373,74.6
3,68,66,70,66,96,366,73.2
4,69,81,85,91,66,392,78.4
5,71,84,89,63,72,379,75.8
6,83,70,65,93,74,385,77.0
7,72,79,86,78,94,409,81.8
8,98,77,98,76,64,413,82.6
9,64,64,97,98,76,399,79.8
10,86,60,67,78,63,354,70.8
